XXXXXXXXXXXXXXXXXXXXX
X...X.XXXX....#X..X#X
X.#XX...X#..#X.#.#X.X
XX..XXX##.#X...X.##.X
X#.#.X#X..##..X.X.XXX
X...#X#X#.#..X..X#..X
XXX.#.#.X.#X..#X..##X
X....##X#X.#X###..X#X
X#X..##...XX.XX.X..XX
X..X...##XX#..#..##.X
X...X#.....X.#X.X.#.X
X.#..X..#..X#X.#..#.X
X...#.......#X#.XX.XX
X#.#X.#.#.#.X.#X#X..X
X.XXXX#.#.#.X.#....#X
XX#X.X#..XX.##..###.X
X....#..#..XX.XX.X.#X
XX#.#..X.#..#..##...X
X.##X.XX###XX.#.XX#XX
X..##.#..X#..X...#..X
XXXXXXXXXXXXXXXXXXXXX
