XXXXXXXXXXXXXXXXXXXXX
X.....X#.XX.#.X###.#X
X.X.......X...#..#.XX
XX.#.X.#..#.X...#X.#X
X#X.###..X#.XX.X..#XX
X#..XX#X.#X.X#XX...XX
X.#.X.X.XX..X..XX.#.X
X#.#X.#.#...XX#XX#..X
X.XX..##.X.....##...X
X#.X#X...##XXX#..X..X
XX.XX....##X.#X..XXXX
XX..X.....#...X...XXX
X...#.X#X.X#.X..XXX.X
XX...XX....X..#.X.X.X
X.X.##XX#..X#...#.#.X
X#XX#XX.#.X.##X..#X#X
X.#.X.X#X.XX....###.X
X.X..#.X#..#.#.##...X
X.##X#X#.XX.X.X#....X
X..##..##X.#.##.##X#X
XXXXXXXXXXXXXXXXXXXXX
