XXXXXXXXXXXXXXXXXXXXX
X..#.X.##.X..##X....X
X...#X...#X###.X.#..X
X##..X#...#....X#..#X
X##.#X..#.X#...X##.#X
X#XXXX#XXXXXXXXXXX#XX
X#.##X....X...#X.#..X
X#..#X.#..X....X...#X
X.#..X.#..X....X.#..X
X##.#X.#..X#..#X..##X
XX#XXXXX#XX#XXXXXXX#X
X...#X....X..##X....X
X#..#X#.#.X....X#.#.X
X...#X..#.X##..X....X
X...##.#..X....X.#..X
XXXXXX#XXXXXXX#X#XXXX
X..##X......#.##....X
X...#X..##X....X###.X
X###.X.##.X##.#X....X
X.#..##...X...#X....X
XXXXXXXXXXXXXXXXXXXXX
