XXXXXXXXXXXXXXXXXXXXX
X..X##XXX#####X#X###X
X.#XX.#XXXX#XXX.##X#X
XX#X#X##XXX.X##X#XXXX
XX.#.#X#X#X##X##.###X
XXX#XXX#X#X#X#X#XX##X
X#X.#XX.##X#####XXXXX
X##X.##X##XX####XXX#X
X#XX####X##X#X#XXXX.X
X#XX#X###X.XXX####X#X
X.##XXXX#X#X#XX##XX.X
X#XX#X##.X##.XX#####X
X#XX#XXX.##XX##X##XXX
X##X#XX##X##X###X.##X
XX#X#XXX##XX####XXX#X
XX#X.XXXX##XX###X##.X
X#.X.X###X#X#XX.XX#XX
XX#X.XXX.X#X#XX.##.#X
XX.#.X#X#X.X.X###XX#X
XX#X#..#.#....######X
XXXXXXXXXXXXXXXXXXXXX
