XXXXXXXXXXXXXXXXXXXXX
X....X.#.#X#...##.#.X
X..#.X#...X#...X#..#X
X..#.X##..X##.#X#..#X
X....X....X..#.X#...X
XX.XXXXX.XXXXXXX##XXX
X....X.#..X....X....X
X.#..X.#.#X##.#X.#.#X
X#...X.#..X#...X#.##X
X..#.X#..#X....X....X
XXX#XX#XXXXXXX#X.XXXX
X....X...##....X.#.#X
X...#.....X.##.#....X
X##..X....X.#..X....X
X...#X#...X..##X..##X
XXXXXXXXXXXXXXXX.XXXX
X.##.X#..#X..#.##..#X
X.........X.#..X....X
X#...X....X..##X.#..X
X#..#X...###..#X##..X
XXXXXXXXXXXXXXXXXXXXX
