XXXXXXXXXXXXXXXXXXXXX
X..XXXX.X...X...#X..X
X.#.X.X..##X.#..#X.XX
X#X.#.X####XXX#.X#..X
X..X#..X..##..X...#.X
X.XX...#.....#..X.X.X
X.#.#X..#..#X.#....XX
X..XX..X....X..#....X
X.X..#X.X..#..##.###X
XX..X#X.....#X##.#.#X
X..X...#.X...X......X
X.XX.#......#X.X.#..X
XXX#.X.#X#.X#....X#XX
XX.#.X.X#X....#.X#.#X
X.#X.......XXX...X..X
XX...##.#.##...#.#X.X
X.X.X..#X.....X#....X
X.#.##..#.X..###..XXX
X...XX#....X...X..X.X
XX##.X.X.XXXXX#.####X
XXXXXXXXXXXXXXXXXXXXX
