XXXXXXXXXXXXXXXXXXXXX
X....X###.##...X..#.X
X.#..X....X....X##.#X
X...#X..#.X.#.#X....X
X#...X..#.X#..#X#.##X
XXX#XXX#XXXXXXXXXX.XX
X#.#.X#...X...#X.#..X
X#...X...#####.X##..X
X#.#.....#X.#.#X#...X
X..#.X...#X.#..X...#X
XXXXXXXXXXXXX.XX#XXXX
X.###X...#X#...X##..X
X#...X.#..X....X#...X
X##.#X....X....X....X
X.#..X.#..X.........X
XXXX#XXXX.XXXXXXXXX#X
X#..#X#.#.X.#..X...#X
X...#X#.##X.#....###X
X.#.#.#......#.X.##.X
X..#.X.#.#X#...X..##X
XXXXXXXXXXXXXXXXXXXXX
