XXXXXXXXXXXXXXXXXXXXX
X..##X....X#.#####..X
X...#X....X...#X.#..X
X##.#X....X.#.#X....X
X.#..X#.#.X.##.X....X
XX#.XXXXX.XXXXXXXXX.X
X.#...##.#..#..X....X
X..#.X....X##..X.##.X
X....X.#.#X#.#.X....X
X.###X.#..X#.......#X
XXXXXXXXXXXXXXXXXX#XX
X....X#.#.####.X...#X
X.##.X.#.#X#...X....X
X#..#X##.#...##X..##X
X.##.X#.#.X#.#.X#...X
X#XXXX#XXXXXXXXX.XXXX
X.#..X..##X....X...#X
X.####.#.#.#.#.X.#..X
X.#.#X.#.#X#.#.X.###X
X.###X..#.X.#.#.##..X
XXXXXXXXXXXXXXXXXXXXX
