XXXXXXXXXXXXXXXXXXXXX
X....X....X....X....X
X.........X.........X
X....X....X....X....X
X..............X....X
XXXXXXXXXXXXXXXXX.X.X
X....X....X....X....X
X....X....X....X....X
X....X....X....X....X
X.........X....X....X
XXXXXX.XXXXXX.XXX.XXX
X....X....X.........X
X....X.........X....X
X....X....X....X....X
X....X....X....X....X
XXXX.XXXXXXXXXXX.XXXX
X....X.........X....X
X.........X....X....X
X....X....X.........X
X....X....X....X....X
XXXXXXXXXXXXXXXXXXXXX
