XXXXXXXXXXXXXXXXXXXXX
X..0.........00.....X
X.X0X.X.X.X.X.X.X.X.X
X..0........0.......X
X.X.X.X.X.X.X.X.X.X.X
X000..000...000.....X
X.X.X.X.X.X.X.X.X.X.X
X......0.......0....X
X.X.X.X0X.X.X.X0X.X0X
X..00......0.......0X
X.X.X.X.X.X.X.X.X.X0X
X......0......000...X
X.X.X.X0X.X.X.X.X.X.X
X..0...0............X
X.X0X.X.X.X.X.X.X.X.X
X0....000....00.....X
X0X0X.X.X.X.X0X.X.X.X
X............0......X
X.X.X.X0X.X.X.X.X.X.X
X.....00.....000....X
XXXXXXXXXXXXXXXXXXXXX