XXXXXXXXXXXXXXXXXXXXX
X...................X
X.X.X.X.X.X.X.X.X.X.X
X...................X
X.X.X.X.X.X.X.X.X.X.X
X...................X
X.X.X.X.X.X.X.X.X.X.X
X...................X
X.X.X.X.X.X.X.X.X.X.X
X...................X
X.X.X.X.X.X.X.X.X.X.X
X...................X
X.X.X.X.X.X.X.X.X.X.X
X...................X
X.X.X.X.X.X.X.X.X.X.X
X...................X
X.X.X.X.X.X.X.X.X.X.X
X...................X
X.X.X.X.X.X.X.X.X.X.X
X...................X
XXXXXXXXXXXXXXXXXXXXX