XXXXXXXXXXXXXXXXXXXXX
X......0..000.000...X
X.X.X.X.X.X.X.X.X.X.X
X0...........0.....0X
X.X.X.X.X.X.X0X.X.X.X
X............0......X
X.X.X.X.X.X.X.X.X.X.X
X.........0.........X
X.X.X.X.X.X.X.X0X.X.X
X...000......00.....X
X.X.X.X.X.X.X.X.X.X.X
X............00.....X
X.X.X.X0X.X.X.X.X.X.X
X...................X
X.X.X.X.X0X.X.X.X.X.X
X0...0..............X
X.X.X.X.X.X.X.X.X.X.X
X......00........0..X
X.X0X.X.X.X.X.X.X0X.X
X........0.......0..X
XXXXXXXXXXXXXXXXXXXXX